6 c 6 e c 6 e e c 0
5 3 9 7 d 3 b 9 3 c
5 0 6 f d 6 8 0 2 9
3 e f 9 5 5 6 8 4 4
4 1 5 4 3 9 5 2 f d
7 c 1 1 6 8 3 c 5 1
7 d 2 e 9 6 8 7 f c
5 7 c 1 6 9 0 5 7 d
5 7 f e f c 2 d 3 d
1 1 3 b b 9 0 1 0 1

PATH=
